"####################",
		"####################",
		"####################",
		"####################",
		"####################",
		"####################",
		"####################",
		"####################",
		"####################",
		"####################",
		"#..................#",
		"#..................#",
		"#.....#......#.....#",
		"#.....#......#.....#",
        "####################"