"####################",
		"#........##........#",
		"#.#####..##...####.#",
		"#........##........#",
		"#..................#",
		"#......#....#......#",
		"#......#...##......#",
		"#####..#....#..#####",
		"#......##...#......#",
		"#......#....#......#",
		"#..................#",
		"#..................#",
		"#.....#......#.....#",
		"#.....#......#.....#",
        "####################"